25
10
0.64
WWWWWWWWWWWWWWWWWWWWWWWWW
W                       W
W                       W
W                       W
W                       W
W      F                W
W  +       E   C   -    W
W PPP PPP PPP PPP PPP   W
WSSSSSSSSSSSSSSSSSSSSSSSW
WWWWWWWWWWWWWWWWWWWWWWWWW