84
20
0.64
WWWWWWWWWWWWWWWWWWWWWWWWWWWWWWWWWWWWWWWWWWWWWWWWWWWWWWWWWWWWWWWWWWWWWWWWWWWWWWWWWWWW
W                                                                                  W
W                                                                                  W
W                                                                                  W
W                                                                                  W
W                                                              C   F               W
W                                                       C C    F                   W
W                                             C    E      E        C               W
W                                               PPPPPP    PPPPPPPPPPPP             W
W                                             BB       B                 BB        W
W                                         C                                C    -  W
W                                         BB                               B  PPPPPW
W                                   C           C                                  W
W                    F                         BB                  PPPPPPPPP       W
W                                                  E             PP                W
W     CC             C        C   B   B   PPPP    PPP          PP                  W
W                   PPPP  B  PPP                             PP                    W
W  +             E                                         PP                      W
W PPPP  PPP B PPPPP                                      PP                        W
WWWWWWSSWWWSSSWWWWWSSSSSSSSSSSSSSSSSSSSSSSSSSSSSSSSSSSSSSWWSSSSSSSSSSSSSSSSSSSSSSSSS